11111111
100c0011
110CP001
1E00C011
11111111
